© BNEI & THE iDOLM@STER, 2024
Hoshimachi Sueisei © Cover Corp/Hololive, 2014

Aiko Takamori - Yuki Kaneko
Airi Totoki - Hitomi Harada
Akane Hino - Chinatsu Akasaki
Akari Tsujino - Megu Umezawa
Aki Yamato - Tomo Muranaka
Akira Sunazuka - Miyu Tomita
Anastasia - Sumire Uesaka
Anzu Futaba - Hiromi Igarashi
Arisu Tachibana - Amina Sato
Asuka Ninomiya - Shiki Aoki
Atsumi Munakata - Ayaka Fujimoto
Ayame Hamaguchi - Masumi Tazawa
Chie Sasaki - Asaka Imai
Chieri Ogata - Naomi Ozora
Chitose Kurosaki - Kaoru Sakura
Chiyo Shirayuki - Risa Sekiguchi
Emi Namba - Arisa Date
Eve Santaclaus - Akane Matsunaga
Frederica Miyamoto - Asami Takano
Fumika Sagisawa - M.A.O
Hajime Fujiwara - Minori Suzuki
Haru Yuki - Makoto Koichi
Haruna Kamijo - Mina Nagashima
Hayate Hisakawa - Rika Nagae
Hijiri Mochizuki - Suzuko Hara
Hikaru Nanjo - Sayaka Kamitani
Hina Araki - Rui Tanabe
Hinako Kita - Seria Fukagawa
Hiromi Seki - Saya Aizawa
Hoshimachi Suisei - Herself
Hotaru Shiragiku - Satomi Amano
Izumi Ohishi - Saeko Oki
Kaede Takagaki - Saori Hayami
Kako Takafuji - Rana Morishita
Kanade Hayami - Yuko Iida
Kanako Mimura - Yuka Otsubo
Kaoru Ryuzaki - Natsumi Haruse
Karen Hojo - Mai Fuchigami
Karin Domyoji - Hiyori Nitta
Kirari Moroboshi - Rei Matsuzaki
Koharu Koga - Yuri Komori
Kotoka Saionji - Yukari Anzai
Koume Shirasaka - Chiyo Ousaki
Kozue Yuza - Maki Hanatani
Kyoko Igarashi - Atsumi Tanezaki
Layla - Kana Ichinose
Makino Yagami - Yui Ninomiya
Mayu Sakuma - Yui Makino
Miho Kohinata - Minami Tsuda
Mika Jougasaki - Haruka Yoshimura
Miku Maekawa - Natsumi Takamori
Minami Nitta - Aya Suzaki
Mio Honda - Sayuri Hara
Mirei Hayasaka - Ayaka Asai
Miria Akagi - Tomoyo Kurosawa
Miyu Mifune - Sayaka Harada
Mizuki Kawashima - Nao Toyama
Momoka Sakurai - Haruka Terui
Nagi Hisakawa - Hina Tachibana
Nana Abe - Marie Miyake
Nanami Asari - Honoka Inoue
Nao Kamiya - Eriko Matsui
Natalia - Teru Ikuta
Natsuki Kimura - Kiyono Yasuno
Nina Ichihara - Misaki Kuno
Nono Morikubo - Karin Takahashi
Noriko Shiina - Chiyo Tomaru
Ranko Kanzaki - Maaya Uchida
Reina Koseki - Yuki Nagano
Riamu Yumemi - Seena Hoshiki
Riina Tada - Ruriko Aoki
Rika Jougasaki - Nozomi Yamamoto
Rin Shibuya - Ayaka Fukuhara
Rina Fujimoto - Mayumi Kaneko
Risa Matoba - Hana Tamegai
Ryo Matsunaga - Haruka Chisuga
Sachiko Koshimizu - Ayana Taketatsu
Sae Kobayakawa - Rika Tachibana
Sanae Katagiri - Azumi Waki
Shiki Ichinose - Kotomi Aihara
Shin Sato - Yumiri Hanamori
Shizuku Oikawa - Yuri Noguchi
Shuko Shiomi - Ru Thing
Suzuho Ueda - Nanami Haruno
Syoko Hoshi - Satsumi Matsuda
Takumi Mukai - Yuko Hara
Tamami Wakiyama - Misa Kayama
Tomoe Murakami - Miharu Hanai
Tsukasa Kiryu - Maki Kawase
Uzuki Shimamura - Ayaka Ohashi
Yoshino Yorita - Yuuki Takada
Yui Ohtsuki - Nanami Yamashita
Yuka Nakano - Shino Shimoji
Yukari Mizumoto - Akane Fujita
Yuki Himekawa - Mako Morino
Yukimi Sajo - Mina Nakazawa
Yuko Hori - Eri Suzuki
Yumi Aiba - Juri Kimura
Yuuki Otokura - Yuki Nakashima
Yuzu Kitami - Rarisatago Takeda