© BNEI & THE iDOLM@STER, 2024
Hoshimachi Sueisei © Cover Corp/Hololive, 2014

Aiko Takamori - Yuki Kaneko
Airi Totoki - Hitomi Harada
Akane Hino - Chinatsu Akasaki
Akari Tsujino - Megu Umezawa
Aki Yamato - Tomo Muranaka
Akira Sunazuka - Miyu Tomita
Anastasia - Sumire Uesaka
Anzu Futaba - Hiromi Igarashi
Arisu Tachibana - Amina Sato
Asuka Ninomiya - Shiki Aoki
Chitose Kurosaki - Kaoru Sakura
Hinako Kita - Seria Fukagawa
Hoshimachi Suisei - Herself
Kanade Hayami - Yuko Iida
Kanako Mimura - Yuka Otsubo
Kirari Moroboshi - Rei Matsuzaki
Kotoka Saionji - Yukari Anzai
Kyoko Igarashi - Atsumi Tanezaki
Mika Jougasaki - Haruka Yoshimura
Minami Nitta - Aya Suzaki
Mizuki Kawashima - Nao Toyama
Nagi Hisakawa - Hina Tachibana
Nana Abe - Marie Miyake
Nao Kamiya - Eriko Matsui
Rin Shibuya - Ayaka Fukuhara
Risa Matoba - Hana Tamegai
Shiki Ichinose - Kotomi Aihara
Syoko Hoshi - Satsumi Matsuda
Tomoe Murakami - Miharu Hanai
Tsukasa Kiryu - Maki Kawase
Uzuki Shimamura - Ayaka Ohashi
Yukari Mizumoto - Akane Fujita
Yuko Hori - Eri Suzuki
Yumi Aiba - Juri Kimur
Yuuki Otokura - Yuki Nakashima
